############
#    #     ###
#    #       #
#    # ####  #
#.$  @   ##  #
#    # #    ##
###### ##    #
  #          #
  #    #     #
  ############