    #####
    #   #
    #   #
  ###   ##
  #      #
### # ## #   ######
#   # ## #####  $.#
#               $.#
##### ### #@##    #
    #     #########
    #######